################################################################################################################################################################################
#                                                                                                                                                                              #
#                                                                                                                                                                              #
#                                                                                                                                                                              #
#                                                                                                                                                                              #
#                                                                                                                                                                              #
#                                                                                                                                                                              #
#                                                                                                                                                                              #
#                                                                                                                                                                              #
#                                                                                                                                                                              #
#                                                                                                                                                                              #
#                                                                                                                                                                              #
#                                                                                                                                                                              #
#                                                                                                                                                                              #
#                                                                                                                                                                              #
#                                                                                                                                                                              #
#                                                                                                                                                                              #
#                                                                                                                                                                              #
#                                                                                                                                                                              #
#                                                                                                                                                                              #
#                                                                                                                                                                              #
#                                                                                                                                                                              #
#                                                                                                                                                                              #
#                                                                                                                                                                              #
#                                                                                                                                                                              #
#                                                                                                                                                                              #
#                                                                                                                                                                              #
#                                                                                                                                                                            ###
#                                                                                                                                                                           ####
#                                                                                                                                                                          #####
##                                                                                                                                                                       #######
####                                                                                                                                                                    ########
######                                                                                                                                                                 #########
#######                                                                                                                                                               ##########
########                                                                                                                                                            ############
#########                                                                                                                                                          #############
###########                                                                                                                                                       ##############
############                                                                                                                                                     ###############
#############                                                                                                                                                   ################
##############                                                                                                                                                 ############### #
################                                                                                                                                              ###############  #
#################                                                                                                                                            ################  #
# #################                                                                                                                                         ################   #
#  #################                                                                                                                                       ################    #
#    ################                                                                                                                                     ################     #
#     #################                                                                                                                                 ################       #
#      #################                                                                                                                               ################        #
#       #################                                                                                                                            #################         #
#        ##################                                                                                                                         #################          #
#          #################                                                                                                                      ##################           #
#           #################                                                                                                                   ###################            #
#            ##################                                                                                                               ####################             #
#             ###################                                                                                                           #####################              #
#              #####################                                                                                                     #######################               #
#                #####################                                                                                                ########################                 #
#                 #######################                                                                                        ###########################                   #
#                   ########################                                                                                     ##########################                    #
#                     ##########################                                                               ###########       ########################                      #
#                      ############################       #############       ########         ########        ###########       #######################                       #
#                        ###########################      #############       ########         ########        ###########       #####################                         #
#                          #########################       ############       ########         ########        ###########       ###################                           #
#                           ########################       ############       #########        ########        ############       ###############                              #
#                             ######################       ############       #########        ########        ############       ############                                 #
#                                ###################       ############        ########        ########        ############       #########                                    #
#                                    ###############       ############        ########        ########        ############       #######                                      #
#                                       ############       ############        ########        ########        ############       ##                                           #
#                                           ########       ############        ########        ########        ############                                                    #
#                                               ####       ############        ########        ########        #####                                                           #
#                                                          ############        ########         #######                                                                        #
#                                                                                                                                                                              #
#                                                                                                                                                                              #
#                                                                                                                                                                              #
#                                                                                                                                                                              #
#                                                                                                                                                                              #
#                                                                                                                                                                              #
#                                                                                                                                                                              #
#                                                                                                                                                                              #
#                                                                                                                                                                              #
#                                                                                                                                                                              #
#                                                                                                                                                                              #
#                                                                                                                                                                              #
#                                                                                                                                                                              #
#                                                                                                                                                                              #
#                                                                                                                                                                              #
#                                                                                                                                                                              #
#                                                                                                                                                                              #
#                                                                                                                                                                              #
#                                                                                                                                                                              #
#                                                                                                                                                                              #
#                                                                                                                                                                              #
#                                                                                                                                                                              #
#                                                                                                                                                                              #
#                                                                                                                                                                              #
#                                                                                                                                                                              #
################################################################################################################################################################################
