########################################################################################################################################################################################
#                                                                                                                                                                                      #
#                                                                                                                                                                                      #
#                                                                                                                                                                                      #
#                                                                                                                                                                                      #
#                                                                                                                                                                                      #
#                                                                                                                                                                                      #
#                                                                                                                                                                                      #
#                                                                                                                                                                                      #
#                                                                                                                                                                                      #
#                                                                                                                                                                                      #
#                                                                                                                                                                                      #
#                                                                                                                                                                                      #
#                                                                                                                                                                                      #
#                                                                                                                                                                                      #
#                                                                                                                                                                                      #
#                                                                                                                                                                                      #
#                                                                                                                                                                                      #
#                                                                                                                                                                                      #
#                                                                                                                                                                                      #
#                                                                                                                                                                                      #
#                                                                                                                                                                                      #
#                                                                                                                                                                                    ###
#                                                                                                                                                                                  #####
#                                                                                                                                                                                #######
#                                                                                                                                                                               ########
#                                                                                                                                                                             ##########
#                                                                                                                                                                            ###########
##                                                                                                                                                                         #############
#####                                                                                                                                                                     ##############
#######                                                                                                                                                                  ###############
########                                                                                                                                                               #################
##########                                                                                                                                                            ##################
###########                                                                                                                                                          ################  #
#############                                                                                                                                                       ################   #
##############                                                                                                                                                     ################    #
################                                                                                                                                                  ################     #
#################                                                                                                                                                ################      #
##################                                                                                                                                              ################       #
# #################                                                                                                                                            ################        #
#   ################                                                                                                                                          ################         #
#    ################                                                                                                                                        ################          #
#      ###############                                                                                                                                      ################           #
#       ################                                                                                                                                  #################            #
#        ################                                                                                                                                #################             #
#         ################                                                                                                                             ##################              #
#          #################                                                                                                                         ###################               #
#           #################                                                                                                                       ###################                #
#            #################                                                                                                                    ####################                 #
#             ##################                                                                                                                #####################                  #
#              ###################                                                                                                           ######################                    #
#               ####################                                                                                                       #######################                     #
#                 ####################                                                                                                  #########################                      #
#                  ######################                                                                                            ###########################                       #
#                   #######################                                                                                       ############################                         #
#                     ########################                                                                      ########      ##########################                           #
#                      #############################                                            #########       #############     #########################                            #
#                        #############################       ###########       #########        #########       #############      ######################                              #
#                         ############################       ############      #########        #########       #############      ####################                                #
#                           ##########################       ############      ##########       #########       #############      ##################                                  #
#                              #######################       ############      ##########       #########       #############      ###############                                     #
#                                #####################       ############       #########       #########       #############      ############                                        #
#                                   ###################      ############       #########       #########       #############      #########                                           #
#                                      ################      ############       #########       #########       #############      ######                                              #
#                                         #############      ############       #########       ##########      #############      ##                                                  #
#                                             #########      ############       #########       ##########      #############                                                          #
#                                                   ###      ############       #########       ##########      ############                                                           #
#                                                                   #####       #########                                                                                              #
#                                                                                                                                                                                      #
#                                                                                                                                                                                      #
#                                                                                                                                                                                      #
#                                                                                                                                                                                      #
#                                                                                                                                                                                      #
#                                                                                                                                                                                      #
#                                                                                                                                                                                      #
#                                                                                                                                                                                      #
#                                                                                                                                                                                      #
#                                                                                                                                                                                      #
#                                                                                                                                                                                      #
#                                                                                                                                                                                      #
#                                                                                                                                                                                      #
#                                                                                                                                                                                      #
#                                                                                                                                                                                      #
#                                                                                                                                                                                      #
#                                                                                                                                                                                      #
#                                                                                                                                                                                      #
#                                                                                                                                                                                      #
#                                                                                                                                                                                      #
#                                                                                                                                                                                      #
#                                                                                                                                                                                      #
#                                                                                                                                                                                      #
#                                                                                                                                                                                      #
#                                                                                                                                                                                      #
#                                                                                                                                                                                      #
#                                                                                                                                                                                      #
#                                                                                                                                                                                      #
########################################################################################################################################################################################
